NO ./textures/texture_1.xpm                     
SO ./textures/texture_2.xpm 
WE     ./textures/texture_3.xpm   
EA ./textures/texture_4.xpm

F    55, 255, 255    
C    66,1,2 



        1111111111111111111111111111
        1000000000110110000000000001
        1011001001111110000000000001
        1001000000000000000000000001
111111111011000001111110000000000001
10000000001100S001111110111111111111
1100000111 1110111101101111000111
1111111111    1111111111111111111111