NO ./textures/texture_1.xpm                     
SO ./textures/texture_2.xpm 
WE     ./textures/texture_3.xpm   
EA ./textures/texture_4.xpm

F    55, 255, 255  
C    66,1,25




        1111111111111111111111111
        1000000000110000000000001
        1011001001110000000000001
        1001000000000000000000001
111111111011000001110000000000001
100000000011000001110111111111111
11110111111111011100000010001
111101111111110111E1010010001
11000000110101011100000010001
10000000000000001100000010001
10000000000000001101010000001
110000011101010111101111000111
111111111111111111111111111111111111111111111111111