SO ./textures/texture_1.xpm
C   0,   191, 255






      NO      ./textures/texture_2.xpm        

		F 0000084,     84,   84
                  WE ./textures/texture_3.xpm
EA ./textures/texture_2.xpm


         


11111111111111111111111111
11111111111000000000000111
10011111111111111111111111
100000E1000000000001000111
10000011000001100000000011
10000001011100000000000001
10000011111111111111111111
11111111111111111111111111