SO ./textures/texture_1.xpm
C   0,   191,      255






      NO      ./textures/texture_2.xpm        

		F 0000084,     84,   84
WE ./textures/texture_3.xpm
EA ./textures/texture_2.xpm
         


         11111111111111111111111111111111        
 1111111111100000001 1
100E111111111111111111111
1000001 10000000000010001
10000011000000110000000001
11111111111111111111111111
100000111	1111111111111111
11111111111111111111111111