SO ./textures/texture_1.xpm
C  0,   191,      255
NO ./textures/texture_4.xpm

F 0,     84,   84

WE ./textures/texture_3.xpm

EA ./textures/texture_2.xpm

11111111111111
100000100000001
1000011111111111111111111
10000011000000000000010001
10000010000000E10000000001
10000011000000000000010001
11111111111111111111111111